Level1
2
2 2 2 2 2
1 1 1 1 1
2 2 2 2 2
1 1 1 1 1
2 2 2 2 2
1 1 1 1 1
Level2
1
2 2 2 2 2
2 2 2 2 2
2 2 2 2 2
2 2 2 2 2
2 2 2 2 2
2 2 2 2 2
Level3
3
3 3 3 3 3
1 1 1 1 1
3 3 3 3 3
1 1 1 1 1
3 3 3 3 3
1 1 1 1 1
Level4
4
4 4 4 4 4
5 5 5 5 5
4 4 4 4 4
5 5 5 5 5
4 4 4 4 4
5 5 5 5 5
